...................m
#.#.###....##.......
.....###....x.......
......###....x......
xxxxxxxxx...........
..........#######.x.
....##.........xxxxx
....................
m.m.m.m.m.m.m.m.m.m.
....................
xx...x.x....o.......
....................
###################.
.............xxxx...
...xxx......#....x.x
..........x.x.x.x..m
mmm..........x.xmm.m
....................
...#######.....##xxx
mmmmmmmmmmmm...mmmmm 